40
23
........................................
........................................
........................................
........................................
........................................
........................................
........................................
...........#####........................
........................................
...................##...................
..............................######....
........................................
.........................#..............
........................##..............
......................####..............
....................######..............
..................########..............
########################################
########################################
########################################
########################################
########################################
########################################
########################################
