40
23
.......................................#
.......................................#
.......................................#
.......................................#
.......................................#
.......................................#
.......................................#
...........#####.......................#
.......................................#
...................##..................#
..............................######...#
.......................................#
.........................#.............#
........................##.............#
......................####.............#
....................######.............#
..................########.............#
########################################
########################################
########################################
########################################
########################################
########################################
########################################
